主著	主著
瞭解	了解
六著心	六著心
共著	共著
前著	前著
勞動	労働
單著	単著
原著	原著
合著	合著
名著	名著
壁著羅	壁著羅
大著	大著
好著	好著
小著	小著
巨著	巨著
便當	弁当
快著	快著
拙著	拙著
新著	新著
舊著	旧著
昭著	昭著
編著	編著
肉絲	肉絲
自著	自著
著作	著作
著名	著名
著增	著増
著大	著大
著式	著式
著志	著志
著於	著於
著明	著明
著書	著書
著減	著減
著白	著白
著稱	著称
著者	著者
著者	著者
著聞	著聞
著莪	著莪
著述	著述
著錄	著録
論著	論著
豆瓣醬	豆板醤
貴著	貴著
較著	較著
近著	近著
迷著	迷著
遺著	遺著
鉅著	鉅著
雜著	雑著
顯著	顕著
高著	高著
