元音	母音 元音
冰棍	冰棒 冰棍
出租車	計程車 出租車
咖喱	咖哩 咖喱
塑料	塑膠 塑料
奔馳	賓士 奔馳
奶酪	乳酪 奶酪
幾率	機率 幾率
方便麵	泡麵 速食麵 方便麵
方便麪	泡麵 速食麵 方便麪
李彥宏	李彥宏 李彥宏
概率	機率 概率
海內存知己	海內存知己 海內存知己
涼菜	冷盤 涼菜
的士	計程車 的士
砹	砈 砹
硅	矽 硅
程序不正義	程序不正義 程序不正義
程序正義	程序正義 程序正義
空氣淨化器	空氣清淨機 空氣淨化器
納米	奈米 納米
自行車	腳踏車 自行車
詞組	片語 詞組
蹦極	高空彈跳 蹦極
輔音	子音 輔音
通過	透過 通過 通過
酰	醯 酰
鈁	鍅 鈁
鈈	鈽 鈈
錇	鉳 錇
鍀	鎝 鍀
鎄	鑀 鎄
鎇	鋂 鎇
鎿	錼 鎿
鐦	鉲 鐦
鑥	鎦 鑥
黃宏	黃宏 黃宏
借記卡	簽帳金融卡 借記卡
